000000000001000
000000000111000
000000011000010
000000110111111
000001100101100
000010111010000
000011001000111
000011001101000
000011111110010
000100000001001
000100101010001
000101100011011
000101101111010
000101110010001
000110110000000
000110111011111
000111010111001
000111101001100
001000100001100
001001010111000
001001011010011
001001100011101
001001101101011
001010010001110
001010111111010
001011100111101
001011111111011
001100101111010
001100110101000
001101000010001
001101001101111
001101010001011
001101110011010
001110000011110
001111000000010
001111000110111
001111010000100
001111101110001
010001110100000
010010001100111
010100010010011
010100011000000
010101001001001
010101010011000
010110011111101
010110101010011
010111010001011
010111011101010
010111011111111
011000000111110
011000110101110
011000110110011
011000111100110
011000111101110
011001001010011
011010100010000
011100001011101
011100011011110
011100100100010
011100110011001
011100111101101
011101100100110
011110111100111
011111000010001
011111100011110
100000011011000
100000100101111
100001001001111
100001110100100
100001111110001
100010000001101
100010001011100
100010001100111
100011001010110
100011101011111
100011110001010
100110011100100
100110100100100
100110101001111
100111000100010
101000010001100
101001000011000
101001010011100
101001100111011
101001101100001
101001110001110
101001110101011
101001111011101
101001111011110
101010000011011
101010001010011
101010001101111
101010011000100
101010101000010
101010110001101
101011011111110
101011101000011
101011101011110
101100010010010
101100010011011
101101110100100
101110111101110
101111000011101
