0000000100001010
0000000111011110
0000001010000000
0000010001100110
0000010110000000
0000011010111101
0000100010000111
0000101101011101
0000110101011001
0000110111000101
0000110111011011
0000111010100001
0000111010101000
0000111100000001
0000111110110010
0001000010111110
0001000011111101
0001001000010001
0001001010010001
0001010001100011
0001100001011000
0001100010001100
0001100100110010
0001100101011110
0001101000110111
0001101001101111
0001110010001100
0001110111001100
0001111001100001
0001111011101001
0010000011010110
0010000011101011
0010001000100001
0010001011101000
0010010100000011
0010011011011110
0010100001010111
0010100001011000
0010101011011000
0010101110000101
0010101110000110
0010101110001010
0010101111010000
0010111001110111
0010111100111000
0011000000111001
0011000010111001
0011000100100110
0011000111001010
0011000111001110
0011000111111010
0011001001100000
0011001101000000
0011010001111100
0011010100000011
0011011000001100
0011100011001011
0011100011100011
0011101010101001
0011101011001100
0011101100010001
0011101110101110
0011110000100011
0011110101100010
0011111010011101
0100000101011001
0100001011011100
0100001011101001
0100010001101110
0100010110100011
0100011001001110
0100011011000001
0100101110101100
0100101111101010
0100101111110010
0100110100000111
0100111110001101
0100111110100111
0101000000001110
0101000010000000
0101000010110011
0101001011110100
0101001100100000
0101001100110000
0101011010100100
0101011100110000
0101100001010010
0101100011011011
0101100101101110
0101101000000110
0101101001101010
0101101010101010
0101110011011000
0101110100010000
0101110110110000
0101110111101001
0101111010101011
0110000000000100
0110000000010100
1000000101101001
1000000110010100
1000001100011000
1000001111101001
1000010010011110
1000010100101101
1000010111011011
1000011100101101
1000011110100111
1000100100000011
1000100100001100
1000100100010101
1000100101010100
1000100110111110
1000101100010101
1000110010001000
1000110010111001
1001000000100110
1001000001010101
1001000001111100
1001000010110001
1001000111010100
1001001010101101
1001001011100011
1001010000110010
1001010001010110
1001010111000000
1001011000010110
1001011000111111
1001011001011101
1001011001101000
1001011011000011
1001011011001000
1001011111001110
1001011111100110
1001100011101100
1001100011110011
1001100110000001
1001111001100011
1001111010111011
1010011010001100
1010011111111001
1010101101001101
1010101101010000
1010101110111000
1010110001111001
1010111000100001
1010111010010100
1011000000001010
1011000010111100
1011000011110110
1011000111100100
1011001111101111
1011010001011100
1011010111100101
1011010111111001
1011011100000110
1011011101001100
1011100100000100
1011100100110010
1011100101100011
1011100111010001
1011100111111000
1011101001011000
1011101010110101
1011101100100000
1011101110001111
1011110001101101
1011110101001100
1011111000101001
1011111110110000
1011111111100110
1100000101001111
1100010011111011
1100010111000011
1100011101110111
1100100000010001
1100100011011001
1100100111101001
1100101111011101
1100110011011101
1100111010000101
1101000001110110
1101000111011111
1101010010101010
1101011000011110
1101011111100100
1101100101010101
1101101000000101
1101101001000101
1101101100001010
1101101111001111
1101110000001001
1101110000001101
1101110000011011
1101110011101101
1101111000110011
1101111001010100
1110000000101010
1110000000101101
