000000100001010
000000111011110
000001010000000
000010001100110
000010110000000
000011010111101
000011011011111
000100010000111
000101110100011
000110000001011
000110011001100
000110101011001
000111001110100
000111100000001
001000001011101
001000010111110
001000011111101
001000100001111
001000101001001
001010001000010
001010001100011
001011000111000
001011001001100
001011101011001
001011110011111
001100010001100
001100100110010
001100110000101
001100110110110
001101000110111
001101001001011
001101001101111
001101010101011
001101101110011
001101111100010
001110110011111
001110111001100
001111001100001
001111011101001
010000000111001
010000011010110
010000011101011
010000110100010
010001000100001
010001011101000
010010100000011
010010101001110
010011000010110
010100001010111
010100100101100
010101000111100
010101110000101
010101111010000
010110000110000
010110100110000
010111001110111
010111011011000
010111100111000
100000010100110
100000110100111
100000110101011
100000111010111
100001000001111
100001000111101
100001100011101
100010001011001
100010011100000
100010111101001
100011001001110
100100000010100
100100010101000
100100011000000
100100110000101
100101000110101
100101010000110
100101010101001
100101100111010
100101110001011
100101111111111
100110000000000
100110000111101
100111001100011
100111001111010
101000001011010
101000001011101
101000101010010
101001001101110
101001010111001
101001011000110
101001011001010
101010011001001
101010011100000
101010110000000
101011100010101
101011100111000
101011110001110
101011111110110
101100011100111
101100011101101
101100100110101
101100101001101
101101110001001
101101111000111
101110010001100
101110011100100
101110100110101
101110101001000
101111110000100
101111111101011
110000010010000
110000011000001
110000111001010
110000111100101
110001011111011
110001100001101
110010000110001
110010011111000
110010101011110
110010111001101
110011010000001
110011011001000
110011101110011
110101001000111
110101010000111
110101111010010
110101111101101
110110000010101
110110010110101
110110011101101
110110111000110
110111000100100
110111011100010
110111100100111
110111111110001
