00000001101101
00000001111100
00001001011010
00010000111001
00010010101011
00010110010101
00011011101101
00100111011111
00101000001001
00101001100010
00101101010011
00101111001001
00110001010101
00110011111111
00111001101101
01000011110100
01000101010111
01000101111111
01000110001111
01001000111100
01001011001010
01001110001010
01001110011000
01001111100011
01010011010001
01010111001001
01010111011111
01010111110010
01011001001111
01011010110001
01100000011101
01100001101011
01100010111010
01100110101001
01100111111001
01101000100110
01101001000111
01101001110001
01101101110010
01110001000100
01110100111010
01110111001010
01111010010011
01111011110011
01111111101101
10000000001101
10000010010111
10000100101010
10000111011110
10010000101001
10010101111110
10010111011010
10010111100001
10011001111101
10011110001011
10011111000110
10100000010001
10100000100000
10100010011101
10100101010110
10100110110101
10101011100011
10110100111100
10110110000001
10111000011111
10111000100000
10111011010100
10111101000100
10111101110101
10111110000111
10111111100001
