00000000000001
00000000111000
00000011000010
00000011011000
00000101011011
00001010101111
00001010111101
00001101101101
00001110100100
00001111110001
00010111010000
00011000111100
00011001111111
00100011100111
00100101110011
00101111111101
00110101001111
00111011101010
01000001101101
01000010001100
01000110010110
01001001011100
01001011010011
01001011101111
01001100011101
01001101100001
01001101101011
01001111011101
01001111110100
01010000011011
01010010000001
01010010001110
01010011000101
01010101000010
01011000001101
01011011111110
01011101000011
01011101100001
01100010010010
01100010100000
01100111001000
01101000010001
01101010001011
01101010011011
01101110100100
01110001000001
01110001010010
01110001111111
01110010100001
01110111101110
01111101101000
01111110101101
10000100010011
10000110110100
10001110100000
10010001001000
10010100001101
10010101000100
10011000100111
10011000101010
10011101010100
10101001101101
10101100111011
10101101001101
10110011011001
10110111111001
10111010110100
10111011111011
10111011111111
10111100111000
10111111111001
