000000110000110
000000111001110
000001010001110
000010001000111
000010110010101
000010111100101
000011000111010
000011100000001
000011100011110
000011110111001
000100111011111
000101101010011
000101111001001
000111001001100
000111011010101
000111101100001
000111110111101
000111111111101
001000011110100
001000110001111
001000110011101
001001000010110
001001000111100
001001001101111
001001110001010
001010001010111
001010011010001
001010111011100
001011010110001
001100010111010
001100110101001
001100111000101
001101000011011
001101001000111
001101101110010
001110001110011
001110101011101
001110111001010
001111001111000
001111011010111
001111100001110
010000000001101
010000001000001
010000001110000
010000010111101
010001000000100
010001101101010
010010001110010
010010010011111
010010111011010
010011111000110
010100010101111
010100110110101
010101010110101
010101110101101
010110110000001
010110110010111
010110110011000
010110110110111
010111000100000
010111000101000
010111011010100
010111101001011
010111101110101
010111110000010
010111110000111
010111111100001
011001011101010
011010110001000
011011011000110
011011100111100
011011110100011
011100011110111
011100100110010
011101111101100
011110011011011
011110101110010
011110110101011
011111010100000
011111010110110
100000101100111
100001001011010
100010000010010
100010001100001
100010010101011
100011011101101
100011011110101
100101001100010
100110001011110
100110011110110
100111001101101
100111010011010
100111110101011
101000000101110
101000110010000
101001011001010
101001110011000
101100111111001
101101001110001
101101010001111
101101111111100
101111011110011
101111111101101
