000000000010001
000000000010010
000000001101101
000000001111100
000000100011111
000001001010001
000001101001100
000010000111001
000010010011000
000011001010010
000011101100001
000101000001001
000101111101011
000111111110101
001000101111111
001001111100011
001010111011111
001010111110010
001011001001111
001011001100000
001100001000110
001100101111111
001101001000111
001101111001101
001110001000100
001110100111010
001111001000001
001111001110111
010000011001001
010000100001001
010001001010101
010010000101001
010010111100001
010011000000111
010011000010001
010011111010100
010100000000101
010100000100000
010100010011101
010100101001000
010111010110001
010111100010001
010111100111000
010111110010100
010111111100010
011000100100010
011001000110111
011001001000011
011001011100000
011010001010100
011011010111111
011011011100001
011011101110110
011011110001110
011100111001111
011101011101110
011101100011000
011101111001000
011110111100111
011111010000000
011111101000011
011111101100011
100000101101100
100000110001000
100010001011011
100010010111000
100010101110100
100011001000010
100011001001011
100011001001111
100011010110100
100100000110110
100101000000101
100101111000011
100101111010010
100110001010101
100110011111111
100110101001001
100111000011100
100111011111100
100111101011111
101000000101100
101000011100000
101000101010111
101000110010111
101001000110101
101001001010010
101010001001111
101010011010000
101010111001001
101011010110111
101100000011101
101100001101011
101100101110011
101100110101010
101101000100110
101101100000101
101111000001100
101111000101010
101111010010011
101111011100101
101111101101010
101111110101110
