000000001111100
000000010101100
000000101110010
000001010101111
000001101010010
000001111100110
000010001111111
000011000111100
000011001111111
000011110110110
000100110111101
000101010101000
000101100010100
000101101100100
000101110011110
000110011100111
000110110010001
001000110010110
001001000000110
001001010010000
001001011101111
001001100110100
001001110001110
001010010000001
001010011000101
001010110000100
001011010110100
001011100111011
001011101100001
001100001000011
001100001000100
001100010100000
001100111001000
001110001000001
010000101011001
010000110110100
010001010110010
010001110011110
010010100001101
010011000000100
010011000100111
010011000101010
010011000111001
010100101101110
010101100111011
010110001110111
010111111111001
011000110010010
011000111000010
011001010000001
011001011101011
011001111101011
011010001100101
011010100101011
011010111101000
011011000111010
011011100001100
011100101100111
011101011110110
011101111010101
011110011100000
011110111001100
011111101011010
011111110111110
100000000000001
100000101011011
100001010111101
100001100111001
100001101101101
100011000110000
100011010101010
100011110110101
100100011100111
100100101110011
100101110111000
100101111111101
100110100011000
100111011101010
101000001101101
101000011010001
101000100001010
101000100001111
101001001011100
101001011101100
101001111110100
101010000010011
101010011001101
101011000001101
101011011000111
101100000111101
101100011101001
101101010011011
101101010100001
101101101001001
101110000110100
101110001010010
101110001111111
101110010100001
101110011110101
101111101101000
101111110101001
101111110101101
110000001001001
