00000101100111
00000110000110
00000111001110
00001010001110
00010000010010
00010001000111
00010001100001
00010111100101
00011000111010
00011011110101
00011100000001
00011100011110
00011110111001
00110001011110
00110011110110
00111001001100
00111010011010
00111011010101
00111101100001
00111110101011
00111110111101
00111111111101
01000000101110
01000110010000
01000110011101
01001000010110
01001001101111
01010001010111
01010111011100
01100111000101
01101000011011
01101010001111
01101111111100
01110001110011
01110101011101
01111001111000
01111011010111
01111100001110
10000001000001
10000001110000
10000010101101
10000010111101
10000100101011
10001000000100
10001001101011
10001011100110
10001101101010
10010001011001
10010001110010
10010010011111
10010100010111
10010110000001
10010110111110
10010110111111
10100010101111
10100100011001
10101000100101
10101010110101
10101110011010
10101110101101
10101110111101
10101111110001
10110010110110
10110110010111
10110110011000
10110110110111
10110111001101
10111000101000
10111101001011
10111110000010
10111111110101
